{
    "rows": [
        "############################################################",
        "#.........#:::::#,,,,,,,#..................................#",
        "#.DDDD....#:KKK:#,,TTT,,#...DDDDDD....:::::::...,,,,,,,,,..#",
        "#.........#:::::#,,TTT,,#.............:K:K:K:...,,,,,,,,,..#",
        "#.DDDD....#:::::#,,,,,,,#...DDDDDD....:::::::...,,TTTTT,,..#",
        "#.........###:###,,,,,,,#.............:::::::...,,TTTTT,,..#",
        "#...............####,####...DDDDDD....:::::::...,,,,,,,,,..#",
        "#..P.................P..#.......................,,,,,,,,,..#",
        "#.DDDD..........................................,,,,,,,,,..#",
        "#.......*..................................................#",
        "#.DDDD.......;;;;;;;;...#..................................#",
        "#............;;SSSS;;...#..................................#",
        "#............;;;;;;;;...#..................................#",
        "#............;;SSSS;;...#..................................#",
        "#...P........;;;;;;;;..P#..................................#",
        "######..#################..................................#",
        "#.........................####..############################",
        "#........................#.................................#",
        "#..P..................P..#..............P...............P..#",
        "#........................#.................................#",
        "#...;;;;;;;;;;;;;;;;;....#....DDDDDDDDDDD..................#",
        "#...;;;;;;;;;;;;;;;;;....#.................................#",
        "#...;;;SSSSSSSSSS;;;;....#....................;;;;;;;;;;;..#",
        "#...;;;;;;;;;;;;;;;;;....#....DDDDDDDDDDD.....;;;;;;;;;;;..#",
        "#...;;;;;;;;;;;;;;;;;.........................;;SSSSSSS;;..#",
        "#...;;;;;;;;;;;;;;;;;.........................;;;;;;;;;;;..#",
        "#...;;;SSSSSSSSSS;;;;....#....DDDDDDDDDDD.....;;;;;;;;;;;..#",
        "#...;;;;;;;;;;;;;;;;;....#....................;;;;;;;;;;;..#",
        "#..P;;;;;;;;;;;;;;;;;.P..#..............P.....;;SSSSSSS;;..#",
        "#...;;;;;;;;;;;;;;;;;....#....DDDDDDDDDDD.....;;;;;;;;;;;..#",
        "#...;;;;;;;;;;;;;;;;;....#....................;;;;;;;;;;;..#",
        "#........................#....................;;;;;;;;;;;..#",
        "#........................#....................;;;;;;;;;;;..#",
        "#........................#.................................#",
        "#........................#.................................#",
        "#........................#.................................#",
        "#..P..................P..#..............P...............P..#",
        "#........................#.................................#",
        "#........................#.................................#",
        "############################################################"
    ],
    "spawn": {
        "x": 6,
        "y": 8
    },
    "zones": [
        {
            "name": "Кухня",
            "x1": 11,
            "y1": 1,
            "x2": 15,
            "y2": 5
        },
        {
            "name": "Переговорка",
            "x1": 17,
            "y1": 1,
            "x2": 23,
            "y2": 6,
            "isPrivate": true
        },
        {
            "name": "Лаунж",
            "x1": 13,
            "y1": 10,
            "x2": 20,
            "y2": 14
        },
        {
            "name": "Инженеры",
            "x1": 27,
            "y1": 1,
            "x2": 35,
            "y2": 7
        },
        {
            "name": "Столовая",
            "x1": 37,
            "y1": 1,
            "x2": 45,
            "y2": 7
        },
        {
            "name": "Большая переговорка",
            "x1": 47,
            "y1": 1,
            "x2": 57,
            "y2": 9,
            "isPrivate": true
        },
        {
            "name": "Парк",
            "x1": 3,
            "y1": 19,
            "x2": 21,
            "y2": 31
        },
        {
            "name": "Коворкинг",
            "x1": 29,
            "y1": 19,
            "x2": 41,
            "y2": 30
        },
        {
            "name": "Южный лаунж",
            "x1": 45,
            "y1": 21,
            "x2": 57,
            "y2": 33
        }
    ],
    "objects": [
        {
            "id": "office-board",
            "type": "board",
            "label": "Доска команды",
            "url": "https://wbo.ophir.dev/boards/voffice-demo",
            "x": 20,
            "y": 2
        },
        {
            "id": "office-tv",
            "type": "video",
            "label": "Телевизор в лаунже",
            "url": "https://www.youtube.com/embed/jNQXAC9IVRw",
            "x": 17,
            "y": 12
        },
        {
            "id": "office-kitchen-map",
            "type": "map",
            "label": "Карта: кофейни поблизости",
            "url": "https://www.openstreetmap.org/export/embed.html?bbox=37.58,55.73,37.64,55.77&layer=mapnik",
            "x": 13,
            "y": 2
        }
    ],
    "portals": [
        {
            "x": 2,
            "y": 14,
            "to": "coworking",
            "label": "В коворкинг",
            "tx": 15,
            "ty": 8
        }
    ]
}
